NO ./texture/rat.xpm
SO ./texture/horse.xpm
WE ./texture/dog.xpm 
EA ./texture/rabbit.xpm

F 100,100,40
C 211,237,251

        1111111111111111111111111
        10000000001100000000001
        101100000111000000000001
        1001000000000000000001111
11111111101100000111000000001
1000000000110000011101111111111111
11110111111111011100000000001
11110111111111011101010010001
11000000110101011100000010001
10000000000000001100000010011
100000000000000011010100101
11000001110101011111011110N1111
11110111 1110101 101111010001
11111111 1111111 111111111111
