NO ./texture/rat.xpm
SO ./texture/horse.xpm
WE ./texture/dog.xpm 
EA ./texture/rabbit.xpm

F 100,100,40
C 211,237,251

1111
1001
10E1
1001
1111
