NO ./texture/manf1.xpm
SO ./texture/manb1.xpm
WE ./texture/ove.xpm 
EA ./texture/castle.xpm

F 118,118,118
C 90,90,90

1111
1001
10E1
1001
1111
